
handbookUrl             = data["handbookUrl        "]
nIndexFullNameEn        = data["nIndexFullNameEn   "]
nIndexNameEn            = data["nIndexNameEn       "]
tIndexCode              = data["tIndexCode         "]
nIndexCode              = data["nIndexCode         "]
indexReleaseChannel     = data["indexReleaseChannel"]
indexCode               = data["indexCode          "]
introEn                 = data["introEn            "]
indexFullName           = data["indexFullName      "]
nIndexFullName          = data["nIndexFullName     "]
totalReturnIntro        = data["totalReturnIntro   "]
tIndexNameEn            = data["tIndexNameEn       "]
indexFullNameEn         = data["indexFullNameEn    "]
isNetLncomeIndex        = data["isNetLncomeIndex   "]
intro                   = data["intro              "]
tIndexFullName          = data["tIndexFullName     "]
indexBaseDay            = data["indexBaseDay       "]
ifIndexCode             = data["ifIndexCode        "]
numOfStockes            = data["numOfStockes       "]
netReturnIntroEn        = data["netReturnIntroEn   "]
indexBasePoint          = data["indexBasePoint     "]
indicsSeqDescEn         = data["indicsSeqDescEn    "]
indexName               = data["indexName          "]
netReturnIntro          = data["netReturnIntro     "]
isPriceIndex            = data["isPriceIndex       "]
updateTime              = data["updateTime         "]
indicsSeqDesc           = data["indicsSeqDesc      "]
indexDataSourceType     = data["indexDataSourceType"]
launchDay               = data["launchDay          "]
methodologyNameEn       = data["methodologyNameEn  "]
methodologyName         = data["methodologyName    "]
tIndexFullNameEn        = data["tIndexFullNameEn   "]
handbookEnUrl           = data["handbookEnUrl      "]
indicsSeq               = data["indicsSeq          "]
nIndexName              = data["nIndexName         "]
indexNameEn             = data["indexNameEn        "]
totalReturnIntroEn      = data["totalReturnIntroEn "]
tIndexName              = data["tIndexName         "]
isTotalReturnIndex      = data["isTotalReturnIndex "]